11111111
1P000001
10000001
11000011
1E1000C1
11000111
10000101
11111111